"filename", "language", "SCSS", "JavaScript", "CSS", "JSON", "HTML", "comment", "blank", "total"
"e:\Documents\OpenClassrooms\P6\fishEYE\404.html", "HTML", 0, 0, 0, 0, 26, 0, 5, 31
"e:\Documents\OpenClassrooms\P6\fishEYE\index.html", "HTML", 0, 0, 0, 0, 26, 0, 5, 31
"e:\Documents\OpenClassrooms\P6\fishEYE\src\classes\DataStore.js", "JavaScript", 0, 65, 0, 0, 0, 0, 2, 67
"e:\Documents\OpenClassrooms\P6\fishEYE\src\classes\EventsManager.js", "JavaScript", 0, 101, 0, 0, 0, 0, 4, 105
"e:\Documents\OpenClassrooms\P6\fishEYE\src\classes\Medias.js", "JavaScript", 0, 43, 0, 0, 0, 0, 1, 44
"e:\Documents\OpenClassrooms\P6\fishEYE\src\classes\Router.js", "JavaScript", 0, 14, 0, 0, 0, 0, 1, 15
"e:\Documents\OpenClassrooms\P6\fishEYE\src\classes\components\Category.js", "JavaScript", 0, 23, 0, 0, 0, 0, 1, 24
"e:\Documents\OpenClassrooms\P6\fishEYE\src\classes\components\Contact.js", "JavaScript", 0, 52, 0, 0, 0, 0, 1, 53
"e:\Documents\OpenClassrooms\P6\fishEYE\src\classes\components\Lightbox.js", "JavaScript", 0, 21, 0, 0, 0, 0, 1, 22
"e:\Documents\OpenClassrooms\P6\fishEYE\src\classes\components\MediasGrid.js", "JavaScript", 0, 68, 0, 0, 0, 0, 2, 70
"e:\Documents\OpenClassrooms\P6\fishEYE\src\classes\components\PhotographerWidget.js", "JavaScript", 0, 23, 0, 0, 0, 0, 1, 24
"e:\Documents\OpenClassrooms\P6\fishEYE\src\classes\components\PhotographersGrid.js", "JavaScript", 0, 38, 0, 0, 0, 0, 3, 41
"e:\Documents\OpenClassrooms\P6\fishEYE\src\classes\pages\Error.js", "JavaScript", 0, 8, 0, 0, 0, 0, 1, 9
"e:\Documents\OpenClassrooms\P6\fishEYE\src\classes\pages\Home.js", "JavaScript", 0, 26, 0, 0, 0, 0, 2, 28
"e:\Documents\OpenClassrooms\P6\fishEYE\src\classes\pages\Photographer.js", "JavaScript", 0, 82, 0, 0, 0, 0, 3, 85
"e:\Documents\OpenClassrooms\P6\fishEYE\src\getDatas.js", "JavaScript", 0, 6, 0, 0, 0, 0, 0, 6
"e:\Documents\OpenClassrooms\P6\fishEYE\src\json\FishEyeDataFR.json", "JSON", 0, 0, 0, 597, 0, 0, 6, 603
"e:\Documents\OpenClassrooms\P6\fishEYE\src\main.js", "JavaScript", 0, 44, 0, 0, 0, 12, 14, 70
"e:\Documents\OpenClassrooms\P6\fishEYE\src\mediasFactory.js", "JavaScript", 0, 13, 0, 0, 0, 0, 1, 14
"e:\Documents\OpenClassrooms\P6\fishEYE\styles\css\main.css", "CSS", 0, 0, 717, 0, 0, 6, 118, 841
"e:\Documents\OpenClassrooms\P6\fishEYE\styles\sass\base\_reset.scss", "SCSS", 49, 0, 0, 0, 0, 7, 9, 65
"e:\Documents\OpenClassrooms\P6\fishEYE\styles\sass\base\_typography.scss", "SCSS", 177, 0, 0, 0, 0, 0, 7, 184
"e:\Documents\OpenClassrooms\P6\fishEYE\styles\sass\components\_button.scss", "SCSS", 0, 0, 0, 0, 0, 0, 1, 1
"e:\Documents\OpenClassrooms\P6\fishEYE\styles\sass\components\_carousel.scss", "SCSS", 0, 0, 0, 0, 0, 0, 1, 1
"e:\Documents\OpenClassrooms\P6\fishEYE\styles\sass\components\_category.scss", "SCSS", 18, 0, 0, 0, 0, 0, 2, 20
"e:\Documents\OpenClassrooms\P6\fishEYE\styles\sass\layout\_container.scss", "SCSS", 21, 0, 0, 0, 0, 0, 1, 22
"e:\Documents\OpenClassrooms\P6\fishEYE\styles\sass\layout\_footer.scss", "SCSS", 22, 0, 0, 0, 0, 0, 2, 24
"e:\Documents\OpenClassrooms\P6\fishEYE\styles\sass\layout\_header.scss", "SCSS", 17, 0, 0, 0, 0, 0, 2, 19
"e:\Documents\OpenClassrooms\P6\fishEYE\styles\sass\layout\nav.scss", "SCSS", 21, 0, 0, 0, 0, 0, 3, 24
"e:\Documents\OpenClassrooms\P6\fishEYE\styles\sass\main.scss", "SCSS", 12, 0, 0, 0, 0, 0, 5, 17
"e:\Documents\OpenClassrooms\P6\fishEYE\styles\sass\pages\_index.scss", "SCSS", 38, 0, 0, 0, 0, 6, 4, 48
"e:\Documents\OpenClassrooms\P6\fishEYE\styles\sass\pages\_photographer.scss", "SCSS", 326, 0, 0, 0, 0, 5, 8, 339
"e:\Documents\OpenClassrooms\P6\fishEYE\styles\sass\utils\_keyframes.scss", "SCSS", 0, 0, 0, 0, 0, 0, 1, 1
"e:\Documents\OpenClassrooms\P6\fishEYE\styles\sass\utils\_mixins.scss", "SCSS", 9, 0, 0, 0, 0, 0, 2, 11
"e:\Documents\OpenClassrooms\P6\fishEYE\styles\sass\utils\_variables.scss", "SCSS", 0, 0, 0, 0, 0, 0, 1, 1
"Total", "-", 710, 627, 717, 597, 52, 36, 221, 2960