"filename", "language", "SCSS", "HTML", "JavaScript", "JSON", "CSS", "comment", "blank", "total"
"e:\Documents\OpenClassrooms\P6\fishEYE\404.html", "HTML", 0, 26, 0, 0, 0, 0, 5, 31
"e:\Documents\OpenClassrooms\P6\fishEYE\index.html", "HTML", 0, 26, 0, 0, 0, 0, 5, 31
"e:\Documents\OpenClassrooms\P6\fishEYE\src\classes\DataStore.js", "JavaScript", 0, 0, 63, 0, 0, 0, 2, 65
"e:\Documents\OpenClassrooms\P6\fishEYE\src\classes\EventsManager.js", "JavaScript", 0, 0, 65, 0, 0, 0, 1, 66
"e:\Documents\OpenClassrooms\P6\fishEYE\src\classes\Medias.js", "JavaScript", 0, 0, 30, 0, 0, 0, 1, 31
"e:\Documents\OpenClassrooms\P6\fishEYE\src\classes\Router.js", "JavaScript", 0, 0, 14, 0, 0, 0, 1, 15
"e:\Documents\OpenClassrooms\P6\fishEYE\src\classes\components\Category.js", "JavaScript", 0, 0, 23, 0, 0, 0, 1, 24
"e:\Documents\OpenClassrooms\P6\fishEYE\src\classes\components\Contact.js", "JavaScript", 0, 0, 52, 0, 0, 0, 1, 53
"e:\Documents\OpenClassrooms\P6\fishEYE\src\classes\components\Lightbox.js", "JavaScript", 0, 0, 21, 0, 0, 0, 1, 22
"e:\Documents\OpenClassrooms\P6\fishEYE\src\classes\components\MediasGrid.js", "JavaScript", 0, 0, 31, 0, 0, 0, 1, 32
"e:\Documents\OpenClassrooms\P6\fishEYE\src\classes\components\PhotographersGrid.js", "JavaScript", 0, 0, 38, 0, 0, 0, 3, 41
"e:\Documents\OpenClassrooms\P6\fishEYE\src\classes\pages\Error.js", "JavaScript", 0, 0, 8, 0, 0, 0, 1, 9
"e:\Documents\OpenClassrooms\P6\fishEYE\src\classes\pages\Home.js", "JavaScript", 0, 0, 26, 0, 0, 0, 2, 28
"e:\Documents\OpenClassrooms\P6\fishEYE\src\classes\pages\Photographer.js", "JavaScript", 0, 0, 79, 0, 0, 0, 3, 82
"e:\Documents\OpenClassrooms\P6\fishEYE\src\json\FishEyeDataFR.json", "JSON", 0, 0, 0, 597, 0, 0, 6, 603
"e:\Documents\OpenClassrooms\P6\fishEYE\src\main.js", "JavaScript", 0, 0, 42, 0, 0, 12, 13, 67
"e:\Documents\OpenClassrooms\P6\fishEYE\src\mediasFactory.js", "JavaScript", 0, 0, 13, 0, 0, 0, 1, 14
"e:\Documents\OpenClassrooms\P6\fishEYE\styles\css\main.css", "CSS", 0, 0, 0, 0, 583, 6, 105, 694
"e:\Documents\OpenClassrooms\P6\fishEYE\styles\sass\base\_reset.scss", "SCSS", 45, 0, 0, 0, 0, 7, 8, 60
"e:\Documents\OpenClassrooms\P6\fishEYE\styles\sass\base\_typography.scss", "SCSS", 101, 0, 0, 0, 0, 0, 6, 107
"e:\Documents\OpenClassrooms\P6\fishEYE\styles\sass\components\_button.scss", "SCSS", 0, 0, 0, 0, 0, 0, 1, 1
"e:\Documents\OpenClassrooms\P6\fishEYE\styles\sass\components\_category.scss", "SCSS", 19, 0, 0, 0, 0, 0, 2, 21
"e:\Documents\OpenClassrooms\P6\fishEYE\styles\sass\css\nav.css", "CSS", 0, 0, 0, 0, 16, 0, 3, 19
"e:\Documents\OpenClassrooms\P6\fishEYE\styles\sass\layout\_container.scss", "SCSS", 21, 0, 0, 0, 0, 0, 1, 22
"e:\Documents\OpenClassrooms\P6\fishEYE\styles\sass\layout\_footer.scss", "SCSS", 22, 0, 0, 0, 0, 0, 2, 24
"e:\Documents\OpenClassrooms\P6\fishEYE\styles\sass\layout\_header.scss", "SCSS", 17, 0, 0, 0, 0, 0, 2, 19
"e:\Documents\OpenClassrooms\P6\fishEYE\styles\sass\layout\nav.scss", "SCSS", 14, 0, 0, 0, 0, 0, 2, 16
"e:\Documents\OpenClassrooms\P6\fishEYE\styles\sass\main.scss", "SCSS", 12, 0, 0, 0, 0, 0, 5, 17
"e:\Documents\OpenClassrooms\P6\fishEYE\styles\sass\pages\_index.scss", "SCSS", 38, 0, 0, 0, 0, 6, 4, 48
"e:\Documents\OpenClassrooms\P6\fishEYE\styles\sass\pages\_photographer.scss", "SCSS", 284, 0, 0, 0, 0, 5, 6, 295
"e:\Documents\OpenClassrooms\P6\fishEYE\styles\sass\utils\_keyframes.scss", "SCSS", 0, 0, 0, 0, 0, 0, 1, 1
"e:\Documents\OpenClassrooms\P6\fishEYE\styles\sass\utils\_mixins.scss", "SCSS", 9, 0, 0, 0, 0, 0, 2, 11
"e:\Documents\OpenClassrooms\P6\fishEYE\styles\sass\utils\_variables.scss", "SCSS", 0, 0, 0, 0, 0, 0, 1, 1
"Total", "-", 582, 52, 505, 597, 599, 36, 199, 2570